C 0, 128 ,   255

NO ./textures/nord.xpm

SO ./textures/sud.xpm

WE ./textures/ouest.xpm

EA ./textures/est.xpm

F  0, 153, 0

           111
           101    111
1111111111110111111111111111111111
11101111111100000000000000011111
100000000000000011100010000111
11100010000000000000000000111111
  100001111111000000000000111111
1111111100000000000N000000001
111100000000001110000000000011
110000000000011 111100000000011
10000000000011111000010000001
11000000000011101001100001111  
11000000000111100000110000011
11111111111111111111111111111111